ALPHA	AE L F AH
BOO	B UW
CAR	K AA R
COMPUTER	K AH M P Y UW T ER
DOWN	D AW N
EFFORT	EH F ER T
FUN	F AH N
GAME	G EY M
HOLE	HH OW L
INTENT	IH N T EH N T
JAY	JH EY
KANGAROO	K AE NG G ER UW
LETS	L EH T S
LORE	L AO R
MENACE	M EH N AH S
MENACE(2)	M EH N IH S
NEON	N IY AA N
OKAY	OW K EY
OPEN	OW P AH N
PLACE	P L EY S
POWER	P AW ER
QUEEN	K W IY N
REST	R EH S T
SUCK	S AH K
TALK	T AO K
TIN	T IH N
UDDER	AH D AH R
VENOM	V EH N AH M
WAR	W AO R
XEROX	Z IH R AA K S
YELLOW	Y EH L OW
ZEBRA	Z IY B R AH
